
#################
#  #         #  #
#  #         #  ##################
#  #         #              #    #
#  #         #              #    #
#   #######  #     ##########    #
###       #  #              #    #
####################        #    #
#####      #                     #
#          #                     #
#          #       #             #
#          #       #             #
#          #       #             #
           #       #             #
 ################  ###############
               #           #######
               #
               ##########$
